1111111111111111111
1C0001C000000C000E1
1010010000000000001
1000000111000000001
10P0000001000C00011
1111111111111111111