1111111111111111111
100C0100000000000E1
10000100000000C0001
1000000111000000001
10P00000C1000000111
1111111111111111111