11111111111111
00000000000001
11111111111111