1111111111111111111
1111011101110101011
1110101101110101111
1101011100110001111
1111111011111111111