1111111111111111111
1111011101110111111
1111111101111111111
111101111111011111
1111111011111111111