1111111111111111111
1000010000000000001
1000010000000000001
1000000111000000001
10p0000001000000111
1000000001000000001
1111111111111111111