1111111111111111111
100c0100000000000E1
10000100000000c0001
1000000111000000001
10000000c1000000111
1p00000001000000001
1111111111111111111