1111111111111111111
100C0100000000000E1
1000010D000000C0001
10000001110000D0001
1P0D0000C1000D00111
1111111111111111111