1111111111111
10D0C1100C011
1P10100000101
1000C0D1000E1
1101010101011
1111111111111