1111111111111
1000C1100C011
1P10100000101
1000C001000E1
1101010101011
1111111111111