1111111111111111111111111
100110C0001100000E1000P11
1000000100000000011000001
1C11000000D000C1110000001
1000000010000000001001001
1001000000C00100D00000001
100C00010000000000000C001
1111111111111111111111111